C  40,40,40
NO ./textures/north.xpm


 SO ./textures/south.xpm


EA ./textures/east.xpm


F 100,0,140

WE ./textures/west.xpm



111111111111111111111111111111111111111111111111111111
100000000000000000000000000000000000000000000000000001111111111111111111111111111111111111111111111111111111
100000000000000000000000000000000000000000000000000001100000000000000000000000000000000000000000000000000001
100000000000000000000000000000000000000000000000000001100000000000000000000000000000000000000000000000000001
100000000000000000000000000000000000000000000000000001100000000000000000000000000000000000000000000000000001
100000000000000000000000000000000000000000000000000001100000000000000000000000000000000000000000000000000001
100000000000000000000000000000000000000000000000000000000000000000000000000000000000000000000000000000000001
100000000000000000000000000000000000000000000000000000000000000000000000000000000000000000000000000000000001
100000000000000000000000000000000000000000000000000000000000000000000000000000000000000000000000000000000001
100000000000000000000000000000000000000000000000000000000000000000000000000000000000000000000000000000000001
100000000000000000000000000000000000000000000000000000000000000000000000000000000000000000000000000000000001
100000000000000000000000000000000000000000000000000000000000000000000000000000000000000000000000000000000001
100000000000000000000000000000000000000000000000000000000000000000000000000000000000000000000000000000000001
100000000000000000000000000000000000000000000000000000000000000000000000000000000000000000000000000000000001
100000000000000000000000000000000000000000000000000000000000000000000000000000000000000000000000000000000001
100000000000000000000000000000000000000000000000000000000000000000000000000000000000000000000000000000000001
100000000000000000000000000000000000000000000000000000000000000000000000000000000000000000000000000000000001
100000000000000000000000000000000000000000000000000000000000000000000000000000000000000000000000000000000001
100000000000000000000000000000000000000000000000000000000000000000000000000000000000000000000000000000000001
100000000000000000000000000000000000000000000000000000000000000000000000000000000000000000000000000000000001
100000000000000000000000000000000000000000000000000000000000000000000000000000000000000000000000000000000001
100000000000000000000000000000000000000000000000000000000000000000000011111111111111111111111111111111111111
1000000000000000000000000000000000000000000000000000000000000000000001
100000000000000000000000000000000000000000000000000000000000000000001
10000000000000000000000000000000000000000000000000000000000000000001
1000000000000000000000000000000000000000000000000000000000000000001
1000000000000000000000000000000000000000000000000000000001111111111
111111111111111100000001111111111111111111111111111111111
1000000000000000000000001
10000000000000000N0000001
1111111111111111111111111
