




C  40,127,40
NO ./textures/tree1.xpm


 SO ./textures/tree2.xpm


     EA ./textures/tree3.xpm


F  50,190,0

   WE                ./textures/zaza.xpm




1111111111111
1E1001000001
1000000001001
1011011111101
1001000001001
1000001000001
1111111111111
